
NO ./xpm/wall_1.xpm
SO ./xpm/wall_2.xpm
WE ./xpm/wall_3.xpm
EA ./xpm/wall_4.xpm


11111111111111111111111111
10000000000000000000000001
10000000000000000000000011
10000000000000000000000111
11111111111111111111111111
