NO xpm/sand_floor.xpm
SO xpm/sand.xpm
WE xpm/stone_wall.xpm
EA xpm/stone.xpm

111111
100001
10N001
100011
100001
100001
10000111111111111111111111
10000000000000000000000011
10000000000000000000000011
10000000000000000000000111
11111111111111111111111111