NO SRCS/XPM/stone_wall.xpm
SO SRCS/XPM/stone_wall.xpm
WE SRCS/XPM/stone_wall.xpm
EA SRCS/XPM/stone_wall.xpm

F 250,100,177
C 111,176,189

111111
100001
100001
100011
100001
100001
10000111111111111111111111
100000N000000000000000011
10000000011110000000000011
10000000000001111100000111
11111111111111111111111111

